WWWWWWWWWWWWWWWWW
W---R---W-------W
W------------G--W
W-G-----R-------W
W---------------W
W---G---W-------W
W-------W-------W
E-------W-------W
W---R-----------W
WWWWWWWWWWWWWWWWW